15 15
100 100
6 4 4 4 4 4 4 4 4 4 4 4 4 4 8
5 3 3 3 3 3 3 2 3 3 3 3 3 3 5
5 3 3 3 3 3 3 2 3 3 3 3 3 3 5
5 3 3 3 2 2 2 2 2 2 2 2 2 2 5
5 3 3 3 2 1 1 1 9 9 9 9 9 1 5
5 3 3 3 2 9 9 9 9 9 9 9 9 9 5
5 3 3 3 2 9 9 9 9 9 9 9 9 9 5
5 3 3 3 2 9 9 9 9 9 9 9 9 9 5
5 3 9 3 2 9 9 9 9 9 9 9 9 9 5
5 3 3 3 2 1 1 1 1 1 9 9 9 9 5
5 3 3 3 2 1 1 1 1 1 1 1 1 1 5
5 3 3 3 2 1 1 1 1 1 1 1 1 1 5
5 3 3 3 2 9 9 9 9 9 9 1 1 1 5
5 3 3 3 3 3 3 3 3 3 3 3 3 3 5
0 4 4 4 2 2 4 4 4 4 4 4 4 4 7